16 16
4 2
0000 0000 0000 0000 0000 0000 0000 0000 0000 0000 0000 0000 0000 0000 0000 0000 
0000 2001 0000 0000 0000 0000 0000 0000 0000 0000 0000 0000 0000 0000 0000 0000 
0000 0000 0000 0000 0000 3002 0000 3001 0000 0000 0000 0000 0000 0000 0000 0000 
0000 0000 0000 0000 0000 0000 0000 0000 0000 0000 0000 0000 0000 0000 0000 0000 
0000 0000 0000 0000 0000 0000 3004 0000 0000 0000 0001 0000 0000 0000 0000 0000 
1010 1003 1004 0000 0000 0000 0000 0000 0000 0000 0000 0000 0000 1001 0000 0000 
1009 1002 1005 0000 0000 1001 1001 1001 1001 1001 1001 1001 1001 1001 1001 1001 
1008 1007 1006 0000 0000 0000 0000 0000 0000 0000 0000 0000 0000 0000 0000 0000 
0000 0000 0000 0000 0000 0000 0000 0000 0000 0000 0000 0000 0000 0000 0000 0000 
0000 0000 0000 0000 0000 0000 0000 0000 0000 0000 0000 0000 0000 0000 1001 1001 
1001 0000 0000 0000 0000 0000 0000 0000 0000 0000 0000 0000 0000 0000 1001 1001 
1001 1001 1001 1001 1001 1001 1001 1001 1001 1001 1001 1001 1001 1001 1001 1001 
0000 1001 1001 1001 0000 0000 0000 0000 0000 0000 0000 0000 0000 0000 0000 0000 
0000 1001 1001 1001 0000 0000 0000 0000 0000 0000 0000 0000 0000 0000 0000 0000 
0000 0000 0000 0000 0000 0000 0000 0000 0000 0000 0000 0000 0000 0000 0000 0000 
0000 0000 0000 0000 0000 0000 0000 0000 0000 0000 0000 0000 0000 0000 0000 0000 
