16 16
301 401
000 000 000 000 000 000 000 000 000 000 000 000 000 000 000 000 
000 000 000 000 000 000 000 000 000 000 000 000 000 000 000 000 
000 000 000 000 000 000 000 000 000 000 000 000 000 000 000 000 
000 101 000 000 000 000 000 000 000 000 000 000 000 000 000 000 
000 000 000 000 000 000 000 000 000 000 000 000 000 000 000 000 
000 000 000 000 000 000 000 000 000 000 000 000 000 000 000 000 
011 011 011 011 011 011 011 011 011 011 011 011 011 011 011 011 
000 000 000 000 011 000 000 000 000 000 000 000 000 000 000 000 
000 001 000 000 011 000 000 000 000 000 000 000 000 000 000 000 
000 000 000 000 011 000 011 000 000 000 000 000 000 000 000 000 
011 000 000 000 011 000 000 000 000 000 000 000 000 000 000 000 
011 019 012 013 000 000 000 000 000 000 000 000 000 000 000 000 
000 018 011 014 000 000 000 000 000 000 000 000 000 000 000 000 
000 017 016 015 000 000 000 000 000 000 000 000 000 000 000 000 
000 000 000 000 000 000 000 000 000 000 000 000 000 000 000 000 
000 000 000 000 000 000 000 000 000 000 000 000 000 000 000 000 
